NO ./textures/e.xpm
SO ./textures/e.xpm
WE ./textures/e.xpm
EA ./textures/e.xpm

C 225,30,0
F 255,100,0





1111111
1N011
1111111
