NO ./textures/cherry_planks.xpm
SO ./textures/chiseled_bookshelf_occupied.xpm
C 139,69,255
WE ./textures/chiseled_bookshelf_empty.xpm
EA ./textures/glowstone32.xpm
F 135,206,235

11111111
111100011
110100011
 110000011
110000001
111111111

    1111
11111001111111
100000000000W1
10000000000001
10000000000001
10000000000001
10000000000001
10000000000001
10000000000001
11111111111111
           111