NO ./textures/e.xpm
SO ./textures/e.xpm
C 139,69,255
WE ./textures/e.xpm
EA ./textures/e.xpm
F 135,206,235

11111111
10000001
11111111

11111111111
10000000111
1000000000111
10000S0000011
1000000000111
1000000000001
10000000001111
10000000000011
10000000000001
11111111111111