NO ./textures/e.xpm
C 139,216,		224
SO ./textures/e.xpm
WE ./textures/e.xpm
EA ./textures/e.xpm
F 84		,57			,34

        1111111111111111111111111
        100D000000110000000000001
        1011000001110000000000001
        10010000000D0000W00000001
111111111011000001110000000000001
100000000011000001110111111111111
11110111111111D11100000010001
11110111111111011101010010001
11000000110101011100000010001
10000000000000001100000010001
10000000000000001101010010001
1100000111010101111101111000111
11110111 1110101 101111010001
11111111 1111111 111111111111
