NO ./textures/e.xpm
WE ./textures/e.xpm
EA ./textures/e.xpm
SO ./textures/e.xpm
F 135,206,235
C 139,69,19

11111111
10000011
10010001
10000001
10000001
111110011111111111
    1E000000000001
    11111111111111

11111111
10000001
10000001
11111111